{
  "data": [
    [
      13, 13, 13, 13, 13, 13, 13, 13, 13, 13, 13, 13, 13, 13, 13, 13, 13, 13,
      13, 13, 13, 13, 13, 13, 13, 13, 14, 13, 13, 15, 13, 13, 13, 13, 13, 13,
      15, 13, 14, 13, 13, 13, 13, 13, 15, 15, 14, 13, 13, 14
    ],
    [
      13, 15, 13, 13, 14, 13, 14, 13, 14, 13, 13, 13, 13, 13, 13, 15, 14, 13,
      13, 13, 13, 13, 15, 13, 13, 13, 14, 13, 13, 13, 13, 13, 13, 13, 13, 13,
      13, 13, 14, 13, 13, 13, 13, 15, 14, 13, 13, 13, 18, 19
    ],
    [
      13, 13, 13, 15, 13, 13, 13, 13, 23, 24, 26, 13, 13, 14, 13, 13, 13, 23,
      24, 26, 13, 13, 15, 14, 13, 13, 13, 13, 13, 23, 24, 23, 24, 15, 13, 13,
      14, 13, 13, 13, 14, 26, 23, 24, 14, 13, 13, 17, 29, 30
    ],
    [
      13, 13, 13, 13, 13, 13, 27, 34, 35, 35, 36, 36, 36, 36, 36, 36, 36,
      36, 36, 36, 36, 36, 36, 36, 36, 36, 36, 36, 36, 36, 36, 36, 36, 36, 36,
      36, 28, 36, 36, 36, 36, 36, 36, 36, 36, 36, 36, 36, 36, 37
    ],
    [
      13, 13, 28, 13, 15, 14, 13, 45, 55, 55, 55, 55, 55, 55, 55, 55, 55, 55,
      55, 55, 55, 55, 55, 55, 55, 55, 55, 55, 55, 55, 55, 55, 55, 55, 55, 55,
      55, 55, 55, 55, 47, 55, 55, 55, 55, 55, 55, 55, 55, 48
    ],
    [
      15, 13, 13, 14, 13, 13, 13, 45, 55, 46, 55, 55, 55, 55, 55, 55, 55, 47,
      55, 55, 55, 55, 55, 47, 55, 55, 55, 55, 46, 55, 55, 55, 47, 55, 55, 55,
      55, 55, 55, 55, 55, 55, 55, 55, 55, 55, 46, 47, 55, 48
    ],
    [
      13, 13, 13, 28, 13, 13, 13, 45, 55, 55, 55, 55, 47, 55, 55, 55, 55, 55,
      55, 55, 55, 55, 55, 55, 55, 55, 55, 55, 55, 55, 55, 55, 55, 55, 55, 55,
      55, 55, 55, 55, 55, 46, 55, 55, 55, 55, 55, 55, 55, 48
    ],
    [
      13, 13, 13, 13, 14, 13, 13, 1, 3, 55, 55, 55, 55, 55, 55, 55, 46, 55, 55,
      55, 55, 55, 55, 55, 55, 55, 55, 55, 55, 55, 55, 55, 55, 55, 55, 55, 55,
      46, 55, 55, 55, 55, 55, 55, 55, 55, 55, 55, 55, 48
    ],
    [
      13, 15, 28, 13, 13, 13, 13, 12, 12, 45, 55, 55, 55, 55, 55, 55, 55, 55,
      55, 55, 55, 55, 55, 55, 55, 55, 47, 55, 55, 55, 55, 55, 55, 55, 55, 55,
      55, 55, 55, 55, 55, 55, 55, 55, 55, 55, 55, 55, 55, 48
    ],
    [
      13, 14, 13, 13, 13, 13, 13, 13, 13, 45, 55, 55, 55, 55, 55, 55, 55, 55,
      47, 55, 55, 55, 55, 55, 46, 55, 55, 55, 55, 55, 47, 55, 55, 46, 55, 55,
      55, 55, 55, 55, 55, 55, 55, 47, 55, 55, 55, 55, 47, 48
    ],
    [
      13, 13, 13, 28, 13, 13, 14, 13, 13, 45, 55, 55, 55, 55, 55, 55, 55, 55,
      55, 55, 55, 55, 55, 55, 55, 55, 55, 55, 55, 55, 55, 55, 55, 55, 55, 55,
      47, 55, 55, 55, 46, 55, 55, 55, 55, 55, 46, 55, 55, 48
    ],
    [
      13, 13, 13, 13, 13, 13, 13, 13, 13, 1, 55, 55, 55, 55, 46, 47, 55, 55, 55,
      55, 55, 55, 47, 55, 55, 55, 55, 55, 55, 55, 55, 55, 55, 55, 55, 55, 55,
      55, 55, 47, 55, 55, 55, 55, 55, 55, 55, 55, 55, 48
    ],
    [
      15, 13, 28, 13, 15, 13, 13, 15, 13, 12, 45, 55, 55, 55, 55, 55, 55, 55,
      55, 55, 55, 55, 55, 55, 55, 47, 55, 55, 55, 55, 55, 55, 55, 55, 55, 55,
      55, 55, 55, 55, 55, 55, 55, 47, 55, 55, 55, 46, 55, 48
    ],
    [
      13, 13, 13, 13, 13, 13, 15, 13, 13, 13, 45, 55, 47, 55, 55, 55, 55, 55,
      55, 55, 55, 55, 55, 46, 55, 55, 55, 55, 55, 55, 55, 55, 47, 55, 55, 55,
      55, 55, 55, 2, 2, 2, 2, 2, 2, 2, 2, 2, 2, 4
    ],
    [
      13, 14, 13, 28, 13, 13, 13, 13, 13, 13, 45, 55, 55, 55, 55, 55, 55, 55,
      55, 47, 55, 55, 55, 55, 55, 55, 55, 55, 55, 55, 55, 55, 55, 55, 55, 55,
      46, 55, 4, 13, 13, 13, 12, 13, 13, 13, 13, 12, 13, 13
    ],
    [
      13, 13, 13, 13, 13, 15, 13, 13, 14, 13, 45, 55, 55, 46, 55, 55, 55, 55,
      55, 55, 55, 55, 55, 55, 55, 55, 55, 55, 55, 55, 46, 55, 55, 55, 55, 3, 3,
      4, 12, 13, 13, 14, 13, 13, 14, 13, 13, 13, 13, 13
    ],
    [
      13, 13, 28, 13, 14, 13, 14, 13, 13, 15, 1, 2, 3, 55, 55, 2, 3, 55, 55, 55,
      55, 55, 46, 55, 47, 55, 55, 55, 55, 55, 55, 55, 55, 55, 48, 12, 13, 13,
      13, 13, 13, 13, 13, 13, 13, 13, 13, 14, 13, 13
    ],
    [
      13, 13, 13, 15, 13, 13, 13, 13, 13, 13, 12, 13, 12, 1, 4, 13, 12, 45, 55,
      55, 55, 55, 55, 55, 55, 55, 55, 55, 55, 47, 55, 55, 55, 55, 48, 13, 13,
      13, 15, 13, 13, 13, 13, 14, 13, 13, 13, 13, 13, 13
    ],
    [
      15, 13, 13, 28, 13, 13, 13, 15, 14, 13, 13, 13, 13, 12, 13, 15, 13, 1, 2,
      3, 2, 3, 2, 3, 2, 3, 2, 3, 2, 3, 2, 3, 2, 3, 4, 13, 14, 13, 13, 13, 13,
      13, 13, 13, 13, 13, 15, 13, 13, 13
    ],
    [
      13, 26, 13, 13, 13, 26, 13, 13, 13, 13, 13, 13, 15, 13, 13, 13, 13, 12,
      13, 13, 13, 13, 13, 13, 13, 13, 12, 13, 13, 13, 13, 13, 13, 12, 12, 13,
      13, 13, 13, 14, 13, 13, 13, 13, 13, 13, 13, 13, 13, 13
    ],
    [
      34, 35, 36, 35, 36, 37, 13, 13, 13, 15, 13, 13, 15, 13, 13, 14, 13, 13,
      14, 13, 13, 13, 13, 13, 13, 14, 13, 13, 13, 14, 13, 15, 13, 13, 13, 13,
      15, 13, 13, 13, 13, 14, 13, 13, 13, 15, 13, 13, 14, 13
    ],
    [
      45, 55, 55, 55, 55, 48, 13, 23, 24, 23, 24, 13, 13, 14, 15, 13, 13, 13,
      13, 13, 15, 13, 13, 13, 13, 13, 13, 13, 13, 13, 13, 13, 13, 14, 13, 14,
      13, 13, 13, 13, 13, 13, 13, 13, 13, 13, 13, 13, 13, 13
    ],
    [
      45, 55, 55, 55, 55, 55, 36, 36, 36, 36, 36, 36, 37, 13, 13, 13, 13, 13,
      13, 15, 13, 13, 13, 17, 13, 13, 13, 13, 14, 13, 15, 13, 13, 13, 13, 15,
      17, 13, 13, 13, 15, 13, 13, 13, 13, 13, 14, 13, 13, 13
    ],
    [
      45, 55, 46, 55, 55, 55, 55, 55, 55, 55, 55, 55, 48, 13, 13, 15, 13, 13,
      14, 13, 13, 13, 15, 13, 13, 13, 13, 13, 13, 13, 13, 13, 14, 13, 13, 13,
      15, 13, 14, 13, 13, 14, 13, 13, 13, 13, 13, 13, 13, 13
    ],
    [
      45, 55, 55, 55, 47, 55, 55, 55, 55, 55, 55, 55, 48, 13, 13, 13, 13, 13,
      13, 13, 13, 13, 13, 13, 14, 13, 27, 13, 13, 7, 8, 15, 13, 28, 13, 14, 13,
      13, 27, 13, 13, 13, 13, 13, 13, 15, 13, 13, 13, 14
    ],
    [
      45, 47, 55, 46, 55, 55, 55, 46, 55, 55, 47, 55, 48, 13, 13, 15, 15, 13,
      13, 13, 18, 19, 5, 6, 5, 6, 5, 6, 5, 6, 5, 6, 5, 6, 5, 6, 5, 6, 18, 19,
      13, 13, 15, 13, 13, 13, 13, 13, 13, 13
    ],
    [
      45, 55, 55, 55, 55, 55, 55, 55, 55, 55, 55, 55, 48, 27, 26, 14, 23, 23,
      24, 13, 29, 30, 16, 16, 16, 16, 16, 16, 16, 16, 16, 16, 16, 16, 16, 16,
      16, 16, 29, 30, 13, 26, 15, 13, 14, 13, 13, 13, 23, 24
    ],
    [
      45, 55, 55, 55, 46, 55, 55, 55, 55, 55, 55, 55, 55, 36, 36, 36, 36, 36,
      36, 36, 7, 8, 7, 8, 7, 8, 7, 8, 7, 8, 7, 8, 7, 8, 7, 8, 7, 8, 7, 8, 36,
      36, 36, 37, 13, 13, 13, 14, 34, 37
    ],
    [
      45, 46, 47, 55, 55, 55, 55, 55, 55, 55, 55, 55, 55, 55, 55, 55, 55, 55,
      55, 55, 55, 55, 55, 55, 55, 55, 55, 55, 55, 55, 55, 55, 55, 55, 55, 55,
      55, 55, 55, 55, 55, 55, 55, 48, 13, 28, 13, 15, 45, 48
    ],
    [
      45, 55, 55, 55, 55, 55, 55, 55, 46, 55, 55, 47, 55, 55, 55, 47, 55, 55,
      46, 55, 55, 55, 55, 55, 46, 55, 55, 55, 55, 55, 55, 47, 55, 55, 46, 55,
      47, 55, 2, 2, 55, 47, 55, 48, 13, 13, 13, 13, 45, 48
    ],
    [
      45, 47, 55, 55, 55, 55, 55, 55, 55, 55, 55, 55, 55, 47, 55, 55, 55, 55,
      55, 55, 55, 55, 55, 55, 55, 47, 55, 55, 46, 55, 55, 55, 55, 55, 55, 55,
      55, 4, 12, 12, 1, 55, 55, 48, 15, 13, 28, 13, 45, 48
    ],
    [
      45, 55, 55, 55, 55, 55, 55, 55, 55, 55, 55, 55, 55, 55, 55, 55, 55, 55,
      55, 55, 55, 55, 55, 55, 55, 55, 55, 55, 55, 55, 55, 55, 55, 55, 55, 55,
      48, 13, 13, 15, 13, 1, 55, 48, 13, 13, 14, 13, 45, 48
    ],
    [
      45, 55, 55, 55, 47, 55, 55, 46, 55, 55, 55, 55, 55, 55, 55, 46, 55, 47,
      55, 55, 55, 55, 55, 47, 55, 55, 47, 55, 55, 55, 55, 55, 55, 47, 55, 55,
      48, 13, 15, 14, 13, 12, 1, 4, 13, 28, 13, 15, 45, 48
    ],
    [
      45, 55, 55, 2, 2, 2, 2, 55, 55, 55, 47, 55, 55, 55, 55, 55, 55, 55, 55,
      55, 55, 46, 55, 55, 55, 55, 55, 55, 55, 46, 55, 47, 55, 55, 46, 55, 48,
      23, 24, 13, 15, 26, 13, 13, 13, 13, 13, 13, 45, 48
    ],
    [
      45, 46, 48, 13, 13, 12, 13, 45, 55, 55, 55, 55, 55, 55, 55, 55, 2, 2, 2,
      2, 2, 2, 2, 2, 2, 2, 2, 2, 2, 55, 55, 55, 55, 55, 55, 55, 55, 36, 36, 36,
      36, 36, 36, 37, 13, 13, 28, 13, 45, 48
    ],
    [
      45, 55, 48, 15, 13, 15, 13, 1, 2, 2, 2, 2, 55, 46, 55, 48, 13, 12, 12, 13,
      13, 13, 13, 13, 12, 13, 13, 13, 13, 1, 2, 2, 2, 2, 2, 3, 55, 55, 55, 55,
      55, 46, 55, 48, 15, 13, 14, 13, 45, 48
    ],
    [
      45, 47, 48, 14, 13, 13, 13, 13, 13, 13, 12, 12, 1, 2, 3, 4, 13, 13, 13,
      14, 13, 13, 13, 13, 13, 13, 13, 13, 13, 12, 13, 13, 13, 13, 13, 12, 45,
      55, 55, 46, 55, 55, 47, 48, 13, 28, 13, 14, 45, 48
    ],
    [
      45, 55, 48, 13, 13, 13, 13, 13, 13, 13, 13, 13, 13, 13, 12, 13, 13, 14,
      13, 13, 13, 13, 13, 13, 13, 13, 13, 13, 13, 13, 14, 13, 13, 13, 13, 13, 1,
      2, 2, 2, 2, 2, 2, 4, 13, 13, 13, 23, 45, 48
    ],
    [
      45, 55, 48, 13, 13, 14, 13, 13, 14, 13, 13, 13, 13, 13, 13, 13, 13, 13,
      13, 13, 13, 13, 13, 15, 13, 13, 13, 13, 13, 13, 13, 13, 15, 13, 13, 13,
      12, 13, 13, 13, 14, 13, 12, 13, 13, 15, 13, 34, 47, 48
    ],
    [
      45, 46, 48, 13, 13, 13, 13, 13, 13, 13, 13, 13, 13, 13, 13, 13, 13, 13,
      13, 13, 14, 13, 13, 13, 14, 13, 13, 13, 14, 13, 13, 13, 13, 13, 13, 13,
      13, 13, 13, 13, 13, 13, 13, 13, 13, 13, 13, 45, 55, 48
    ],
    [
      45, 55, 48, 18, 19, 13, 13, 13, 13, 13, 13, 13, 15, 13, 13, 13, 14, 13,
      13, 13, 13, 13, 13, 13, 13, 13, 13, 13, 13, 13, 13, 13, 13, 13, 13, 14,
      13, 13, 14, 15, 15, 13, 13, 13, 15, 13, 13, 45, 46, 48
    ],
    [
      45, 55, 48, 29, 30, 23, 24, 13, 26, 13, 13, 14, 13, 13, 13, 13, 13, 14,
      13, 13, 13, 13, 13, 13, 15, 13, 13, 14, 13, 13, 13, 13, 15, 13, 15, 13,
      13, 13, 13, 13, 13, 14, 13, 13, 14, 13, 13, 45, 55, 48
    ],
    [
      45, 47, 55, 35, 36, 35, 36, 35, 36, 36, 37, 13, 13, 13, 15, 13, 13, 13,
      13, 13, 15, 13, 13, 13, 13, 13, 13, 13, 13, 13, 15, 13, 15, 15, 13, 13,
      13, 13, 13, 13, 13, 13, 13, 26, 13, 23, 27, 45, 47, 48
    ],
    [
      45, 55, 55, 55, 55, 55, 55, 55, 55, 55, 48, 13, 13, 14, 13, 13, 13, 13,
      13, 13, 14, 13, 13, 13, 13, 28, 13, 13, 13, 13, 13, 15, 13, 13, 13, 13,
      13, 18, 19, 18, 19, 34, 36, 36, 36, 36, 36, 55, 46, 48
    ],
    [
      45, 55, 46, 55, 47, 55, 55, 55, 55, 55, 48, 13, 13, 13, 13, 13, 13, 13,
      13, 13, 13, 7, 8, 13, 13, 13, 13, 13, 13, 13, 15, 13, 13, 13, 13, 13, 13,
      29, 30, 29, 30, 1, 2, 3, 2, 2, 2, 2, 2, 4
    ],
    [
      45, 55, 55, 55, 55, 55, 55, 55, 47, 55, 48, 23, 24, 23, 24, 13, 13, 26,
      13, 13, 13, 13, 13, 13, 13, 13, 13, 13, 13, 13, 26, 13, 13, 13, 13, 28,
      13, 13, 14, 15, 13, 13, 12, 13, 13, 13, 13, 12, 15, 12
    ],
    [
      45, 55, 47, 55, 55, 55, 55, 55, 46, 55, 55, 36, 36, 36, 36, 36, 36, 36,
      36, 37, 13, 13, 13, 15, 13, 13, 13, 13, 28, 13, 34, 36, 37, 13, 13, 13,
      15, 13, 13, 13, 13, 14, 13, 13, 13, 15, 13, 13, 13, 13
    ],
    [
      45, 55, 55, 46, 55, 55, 47, 55, 55, 55, 55, 47, 55, 55, 55, 55, 55, 55,
      55, 48, 5, 6, 5, 6, 5, 6, 5, 6, 5, 6, 45, 46, 48, 5, 6, 5, 6, 5, 6, 5, 6,
      5, 6, 5, 6, 5, 6, 5, 6, 6
    ],
    [
      45, 55, 55, 55, 55, 55, 55, 55, 55, 55, 46, 55, 55, 47, 55, 55, 55, 46,
      55, 48, 16, 16, 16, 16, 16, 16, 16, 16, 16, 16, 45, 47, 48, 16, 16, 16,
      16, 16, 16, 16, 16, 16, 16, 16, 16, 16, 16, 16, 16, 16
    ],
    [
      1, 2, 2, 2, 2, 2, 2, 2, 2, 2, 2, 2, 2, 2, 2, 2, 2, 2, 2, 4, 16, 16, 16,
      16, 16, 16, 16, 16, 16, 16, 1, 3, 4, 16, 16, 16, 16, 16, 16, 16, 16, 16,
      16, 16, 16, 16, 16, 16, 16, 16
    ]
  ]
}
